	Níže uvedený text pochází z prvního vydání. Nad tímto textem se nachází aktuální stav po revizi směřující k druhému vydání.	complang-czcomplang
Programming Languages I Have Used	Programovací jazyky, které jsem používal	complang-czcomplang
This document lists some of the programming languages I have used or investigated (played with) over the years.	V tomto dokumentu uvádím některé z programovacích jazyků, které jsem používal nebo zkoumal (tj. hrál jsem si s nimi) běhe předchozích let.	complang-czcomplang
It is a very personal view and sometimes the views expressed will appear contradictory or even downright quirky.	Jde o velmi osobní pohled. Někdy se vyjádřená hlediska mohou zdát protikladná nebo dokonce zcela překroucená.	complang-czcomplang
That's because they reflect the author's state of mind at the time of using the particular language!	Je to tím, že odrážejí můj stav mysli v době, kdy jsem ten který jazyk používal.	complang-czcomplang
The layout arranges the languages into groups:	Jazyky jsem uspořádal to těchto skupin:	complang-czcomplang
Those that I have used 'in anger' on production work .	Ty, které jsem používal a se kterými jsem se zlobil v práci .	complang-czcomplang
Little languages used (often in production projects) for small tasks (less than 1000 lines of code).	Malé jazyky , které jsem používal (často i v práci) pro řešení malých úkolů (méně, než 1000 řádků zdrojového textu).	complang-czcomplang
Languages which I have only experimented with, never used on real development work.	Jazyky, se kterými jsem pouze experimentoval a které jsem nikdy nepoužíval během opravdových vývojových prací.	complang-czcomplang
Where it makes sense I will present a 'Hello World' program in the language.	Tam, kde to bude dávat smysl, uvedu v daném jazyce program 'Hello World'.	complang-czcomplang
	Poznámka překladatele: Dalo by se přeložit jako 'Ahoj světe!', 'Ahoj lidi!' a podobně.	complang-czcomplang
	Samotný text není důležitý.	complang-czcomplang
	Jde o klasický program, který použili autoři jazyka C ve své knize.	complang-czcomplang
	Program má za úkol pouze vypsat tento řetězec a skončit. Dá se říci, že je to ustálený, klasický demonstrační program.	complang-czcomplang
	Patří obvykle k nejjednodušším programům, který lze v libovolném jazyce napsat.	complang-czcomplang
	Jeho zdrojový kód jasně ukazuje minimum, které musíme jako programátoři napsat, aby program začal navenek komunikovat. Jazyky používané v práci	complang-czcomplang
Production Use		complang-czcomplang
In this context "production" means that I got paid for doing the work and/or that several other people are using the resulting program.	Tím v práci myslím to, že jsem byl za tuto práci placen a že výsledný program používá více jiných lidí.	complang-czcomplang
It also means that the programs were developed using industry standard software engineering practices for design and documentation etc.	Mám zde na mysli také to, že tyto programy byly vyvíjeny s použitím průmyslových standardů pro vývoj software, pro jeho dokumentování a podobně.	complang-czcomplang
C	C	complang-czcomplang
When I first started using C (on a vacation project while at university) it came as a breath of fresh air after the restrictions of ANSI Pascal .	Když jsem poprvé začal používat jazyk C (během prázdninového projektu, v době studia na univerzitě), bylo to jako závan svěžího vzduchu po všech těch omezeních, kladených jazykem ANSI Pascal.	complang-czcomplang
It allowed fast expression of ideas with just enough type checking to let you know if you're being stupid but not enough to suffocate as Pascal did. It also meant excursions into Assembler were limited to those few areas where Assembler was fun!	Jazyk C umožňoval rychlé vyjadřování myšlenek s právě takovou mírou typové kontroly, která vám dá poznat, že něco děláte špatně, ale ne zase s tak přísnou typovou kontrolou, která by vás vyčerpávala, jako v jazyce Pascal. Používání jazyka C současně znamenalo omezení výletů do Assembleru jen na ty oblasti, kde bylo používání Assembleru hračkou.	complang-czcomplang
A few years later I migrated to C++ but over time I now find myself using C++ as a better C and even occasionally preferring the original.	O několik let později jsem přešel k C++. Během času však shledávám, že jazyk C++ používám jako lepší C, přičemž příležitostně dávám přednost originálu.	complang-czcomplang
C++ cranks up the type checking to near Pascal levels and adds whole wadges of new features which complicate the language and slow the compiler.	C++ pozvedává typovou kontrolu téměř na úroveň jazyka Pascal a přidává celou řadu nových rysů, které jazyk komplikují a zpomalují překladač.	complang-czcomplang
C remains one of my favourite languages and its not a coincidence or surprise that the OS everyone is talking about - Linux - is written in vanilla C and not C++.	Jazyk C zůstává jedním z mých oblíbených jazyků. Není to jen shoda okolností, ani to není nijak překvapující, že operační systém, o kterém každý mluví — Linux — je napsán v čistém C a ne v C++.	complang-czcomplang
	Poznámka překadatele: No jo!	complang-czcomplang
	Jenže Unix, jehož odrůdou je i Linux, vznikl současně s jazykem C, v jedné dílně a v jedněch hlavách.	complang-czcomplang
	Je to velmi klasický systém.	complang-czcomplang
	To jinými slovy znamená, že vznikal v době, kdy objektově orientované programování nebylo ani v plenkách.	complang-czcomplang
	Jádro operačního systému unixového typu je založeno na volání funkcí a práci s datovými strukturami (MS Windows v tomto smyslu spadá do stejné kategorie).	complang-czcomplang
	S objekty se zde nesetkáme a použití jakéhokoliv objektově orientovaného programovacího jazyka pro zápis jádra systému proto nemůže přinést velké výhody.	complang-czcomplang
Hello World #include void main() { char* msg="Hello World!"; /* similar idiom as OO examples */ puts(msg); }	Hello World #include <stdio.h> void main() { char* msg="Hello World!"; /* podobný obrat, jako v OO příkladech */ puts(msg); }	complang-czcomplang
C++	C++	complang-czcomplang
	Poznámka překladatele: Funkce main() by podle normy jazyka C měla vracet výsledek typu int . Měli bychom proto psát int main() nebo pouze main() . Mnohé překladače sice zápis void main() tolerují, ale v podstatě je nesprávný.	complang-czcomplang
C++ is C with bells on.	Jazyk C++ lze přirovnat k jazyku C s přidanými zvonečky.	complang-czcomplang
Initially the bells tinkled occasionally and made sweet music.	Ty ze začátku cinkaly jen příležitostně a tvořily sladkou hudbu.	complang-czcomplang
Now there are so many bells you can't hear the music for the noise!	Ale v současnosti je těch zvonečků už tolik, že přes ten hluk už není hudba slyšet!	complang-czcomplang
(And some modern C++ programs look like noise too!)	(A některé moderní programy v C++ podle toho vypadají!)	complang-czcomplang
I have a great admiration for C++ and for very large systems or environments where many different modes of design/programming are practiced it is peerless.	K jazyku C++ chovám hluboký obdiv a pro tvorbu velmi velkých systémů nebo prostředí, kde se používá mnoho odlišných způsobů návrhu a programování, je nepřekonatelný.	complang-czcomplang
Unfortunately that flexibility is also its downfall.	Jeho pružnost naneštěstí přináší i problémy.	complang-czcomplang
It has become almost impossible to program well in C++ without an intimate understanding of its internals, which is ironic given that one of its primary design aims is to allow the programmer to work at a greater level of abstraction.	Bez intimního porozumění jeho vnitřním mechanismům se tvorba dobrých programů v C++ stala téměř nemožnou. Ironií je, že jedním z primárních cílů jeho návrhu je umožnit programátorovi práci na vyšší úrovni abstrakce.	complang-czcomplang
Hello World #include &ltstring.h> #include &ltstdio.h> class Message // define a message class { private: char msg[50]; public: Message(char* s) {strcpy(msg,s);}; void print() {puts(msg);}; }; void main() { m = new Message("Hello World!"); m->print(); delete m; }	Hello World #include <string.h> #include <stdio.h> class Message // definuj třídu pro zprávu { private: char msg[50]; public: Message(char* s) {strcpy(msg,s);}; void print() {puts(msg);}; }; void main() { m = new Message("Hello World!"); m->print(); delete m; }	complang-czcomplang
Delphi	Delphi	complang-czcomplang
	Poznámka překladatele: Podle mého názoru to není C++, které činí uvedený příklad nepřehledným — viz následující protipříklad. Jazyk C++ zcela jistě, v souladu s původními záměry, umožňuje efektivní práci na vyšších úrovních abstrakce.	complang-czcomplang
	Problém spočívá v tom, že to nelze ztotožňovat s jednoduchostí jazyka.	complang-czcomplang
	Hello World 2 — céčková verze v kabátě C++ #include <iostream> #include <string> using namespace std; int main() { string msg("Hello World!"); /* podobný obrat, jako v OO příkladech */ cout << msg; return 0; }	complang-czcomplang
Delphi isn't really a language, its an environment.	Delphi ve skutečnosti není programovacím jazykem. Jde o vývojové prostředí.	complang-czcomplang
But everyone tends to call the language within that environment Delphi too so I'll roll with the flow!	Ale v rámci tohoto vývojového prostředí mají všichni tendenci nazývat takto i jazyk, se kterým v prostředí pracují — takže popluji s proudem.	complang-czcomplang
The real name for the language of Delphi is Object Pascal and it is a (widely divergent) version of the language Apple used to program the first Macs.	Skutečné jméno jazyka uvnitř Delphi je Object Pascal. Jde o (v mnoha směrech odlišnou) verzi jazyka, kterou firma Apple používala pro programování prvních počítačů Macintosh.	complang-czcomplang
This in turn added OOP features to standard Pascal.	Firma Apple ke standardnímu Pascalu přidala rysy související s objektově orientovaným programováním.	complang-czcomplang
(A fuller description and demo of Apple style OP is found in Booch's OOAD 1st edition c1992)	(Podrobnější popis jazyka a ukázky v jazyce Object Pascal v applovské podobě můžete nalézt v prvním vydání Boochovy knihy OOAD, 1992.)	complang-czcomplang
Essentially Delphi's brand of OP adds the best features of C++ to Pascal but without striving for total backward compatibility or no compromise performance etc.	Varianta jazyka Object Pascal, která se používá v prostředí Delphi, v podstatě přidává k jazyku Pascal ty nejlepší rysy z jazyka C++, ale nesnaží se o úplnou zpětnou kompatibilitu nebo o nekompromisní přístup z pohledu výkonnosti a podobně.	complang-czcomplang
This results in a much more human readable and simpler language.	Výsledkem je z lidského hlediska mnohem čitelnější a jednodušší jazyk.	complang-czcomplang
For serious windows programming OP is my language of choice ad the Delphi environment is the best IDE I've used so far.	Pro vážné programování ve Windows je Object Pascal jazykem, kterému dávám přednost. Prostředí Delphi je navíc nejlepším integrovaným vývojovým prostředím, které jsem kdy používal.	complang-czcomplang
(I'm currently on V3 although V4 is the latest version at the time of writing) Hello World program hello; {---------Class definition ---------} type class=TMessage msg : String; public: constructor Create(s : String); procedure Print; end; constructor TMessage.Create(s : String); begin msg := s; end; procedure TMessage.Print; begin writeln(msg); end; {------------End class -----------} var m : TMessage //declare instance reference begin m := TMessage.Create('Hello World'); // create instance m.Print; m.Free; end.	(Momentálně používám verzi 3, ačkoliv v době psaní tohoto textu je má poslední verze číslo 4.) Hello World program hello; {--------- Definice třídy ---------} type class=TMessage msg : String; public: constructor Create(s : String); procedure Print; end; constructor TMessage.Create(s : String); begin msg := s; end; procedure TMessage.Print; begin writeln(msg); end; {------------ Konec definice třídy -----------} var m : TMessage // deklarace reference na instanci begin m := TMessage.Create('Hello World'); // vytvoříme instanci m.Print; m.Free; end.	complang-czcomplang
	Poznámka překladatele: Opět si dovolím upozornit na to, že v každém jazyce lze napsat program dobře a špatně. Jazyk C++ vám možná umožní program napsat více špatnými způsoby. Bez jeho dobré znalosti možná ten správný způsob zapsání programu možná obtížněji naleznete. Ale když se použijí jen ty správné zvonečky , lze z něj stále vyloudit pěknou hudbu. Ale pravda je, že hrát na flašinet typu Visual Basic je asi snazší, než hrát na vícemanuálové varhany C++. Pro každý účel se má používat takový nástroj, který je nejvhodnější. Zkuste si představit žebráka hrajícího na varhany. Na stejném příkladu bych rád ukázal sílu jazyka C++, která nemusí nezbytně vést k menší přehlednosti, než je tomu u Object Pascalu. V následujícím příkladu se snažím o co nejpodobnější zápis výše uvedeného příkladu, včetně shodných identifikátorů a podobně umístěných komentářů: #include <iostream> #include <string> // --------- definice třídy --------- class TMessage { private: std::string msg; public: TMessage(const std::string & s); // konstruktor void Print(); }; TMessage::TMessage(const std::string & s) { msg = s; } void TMessage::Print() { std::cout << msg << std::endl; } // ------------ Konec definice třídy ----------- int main() { TMessage m("Hello World"); // vytvoříme inicializovanou instanci m.Print(); return 0; // tento obrat je doporučen normou } Ale osobně bych stejný příklad napsal spíše takto:	complang-czcomplang
	#include <iostream> #include <string> // Class definition class TMessage { public: TMessage(const std::string & s) { m_msg = s; } void Print() { std::cout << m_msg << std::endl; } private: std::string m_msg; // m_ předpona pro datové členy (member) }; int main() { TMessage m("Hello World"); // vytvoříme inicializovanou instanci m.Print(); return 0; }	complang-czcomplang
COBOL	COBOL	complang-czcomplang
COBOL is one of the earliest computer languages appearing in 1959, just one year after me!	COBOL patří k jednomu z prvních počítačových jazyků. Světlo světa spatřil v roce 1959, právě jeden rok po mně.	complang-czcomplang
It is one of the latest computer languages that I have used however but no better for that!	Je to jeden z posledních počítačových jazyků, které jsem používal. Tím ho ovšem nechci nijak obhajovat.	complang-czcomplang
It is not a popular language amongst programmers and despite trying to maintain a neutral stand, I can only agree with the consensus.	Mezi programátory nepatří zrovna k populárním jazykům. A ačkoliv se snažím o neutrální postoj, nezbývá mi, než s tím souhlasit.	complang-czcomplang
COBOL has a few good features especially those specific to its bread and butter tasks of data processing, number crunching and file handling.	COBOL se vyznačuje několika dobrými rysy, především těmi, které se vztahují k jeho dennímu chlebu — zpracování dat, číselné výpočty a práce se soubory.	complang-czcomplang
In particular its report writing capabilities outshine its contemporaries and its file handling is quite simply the best in the game.	Zejména jeho schopnosti generování sestav zastiňují jeho současníky. Jeho práce se soubory patří prostě k nejlepším.	complang-czcomplang
These don't, however, make up for its negative characteristics: uppercase letters, fixed position keywords and verbosity bordering on the insane.	To ovšem nevyvažuje jeho negativní vlastosti: používání velkých písmen, pevné pozice klíčových slov a ukecanost až k zbláznění.	complang-czcomplang
I will be quite happy never to have to work with COBOL ever again.	Budu docela šťastný, když už s jazykem COBOL nebudu muset nikdy víc pracovat.	complang-czcomplang
Hello World IDENTIFICATION DIVISION.	Hello World IDENTIFICATION DIVISION.	complang-czcomplang
PROGRAM-ID.	PROGRAM-ID.	complang-czcomplang
HELLO-PROG. ******************************* ENVIRONMENT DIVISION.	HELLO-PROG. ******************************* ENVIRONMENT DIVISION.	complang-czcomplang
CONFIGURATION SECTION.	CONFIGURATION SECTION.	complang-czcomplang
SOURCE-COMPUTER.	SOURCE-COMPUTER.	complang-czcomplang
IBM-PC.	IBM-PC.	complang-czcomplang
OBJECT-COMPUTER.	OBJECT-COMPUTER.	complang-czcomplang
IBM-PC. ******************************** DATA DIVISION. ******************************** PROCEDURE DIVISION.	IBM-PC. ******************************** DATA DIVISION. ******************************** PROCEDURE DIVISION.	complang-czcomplang
DISPLAY-PARA.	DISPLAY-PARA.	complang-czcomplang
DISPLAY "HELLO WORLD FROM COBOL!".	DISPLAY "HELLO WORLD FROM COBOL!".	complang-czcomplang
END-PARA.	END-PARA.	complang-czcomplang
STOP RUN.	STOP RUN.	complang-czcomplang
Little Languages	Malé jazyky	complang-czcomplang
The definitive description of little languages is in a series of articles published in Dr Dobbs journal and the ICM.	Vyčerpávající popis malých jazyků naleznete v sérii článků, které byly publikovány v časopise Dr. Dobbs a v ICM.	complang-czcomplang
In particular I recommend the Programming Pearls series of books by Jon Bentley.	Doporučuji sejména sérii knih Programming Pearls , kterou napsal Jon Bentley.	complang-czcomplang
In the context of this discussion I really mean scripting languages ans some of these have actually become pretty big! awk	Malými jazyky zde rozumím skriptovací jazyky. Některé z nich se však ve skutečnosti staly velmi rozsáhlými. awk	complang-czcomplang
The first little language I came across and still a favourite.	Jde o první malý jazyk, se kterým jsem se setkal, a stále patří mezi mé oblíbené.	complang-czcomplang
It does a conceptually simple job simply and reasonably fast.	Pomáhá řešit principiálně jednoduché úkoly jednoduchým a rozumně rychlým způsobem.	complang-czcomplang
Everyone should learn awk.	Měl by se jej naučit každý !	complang-czcomplang
The key principle of operation in awk is pattern matching.	Základní princip zpracování v awk je založen na vyhledávání vzorků.	complang-czcomplang
Awk reads a text file line by line searching for patterns.	Awk čte textový soubor řádek po řádku a vyhledává vzorky.	complang-czcomplang
When it finds a pattern that it recognizes it performs whatever action(sub-routine) has been defined - the default being to print the line.	Pokud nalezne některý z předepsaných vzorků, provede libovolnou akci, která pro něj byla definována. Standardně (default) je touto akcí tisk řádku.	complang-czcomplang
An Awk program thus consists of a set of pattern/action pairs.	Program v awk se tedy skládá z množiny dvojic vzorek/akce.	complang-czcomplang
Typical uses are to extract columns from a data file, or to produce summary reports etc.	Mezi jeho typická použití patří extrahování sloupců z datových souborů, generování souhrnných zpráv a podobně.	complang-czcomplang
Hello world	Hello world	complang-czcomplang
		complang-czcomplang
Note: This version prints "Hello World" every time "Hello" or "hello" is found in the input file, and gives a success count at the end. #!/bin/awk BEGIN {msg="Hello World"} /[Hh]ello/ {print msg; count++} END {print "Hello was found ", count, "times in ", FILENAME}	Poznámka: Tato verze tiskne řetězec " Hello World " pokaždé, když na řádku vstupního souboru nalezne řetězec " Hello " nebo " hello ". Na závěr zobrazí počet úspěšných rozpoznání vzorků. #!/bin/awk BEGIN {msg="Hello World"} /[Hh]ello/ {print msg; count++} END {print "Hello bylo v souboru ", FILENAME, " nalezeno ", count, "krat."}	complang-czcomplang
Perl	Perl	complang-czcomplang
The flavour of the last few years, never mind month, and very powerful. Pity it reads like line noise, and on a very dodgy line at that!	Perl dal příchuť několika posledním rokům, plus mínus nějaký ten měsíc. Jde o mocný nástroj. Škoda jen, že jeho řádky vypadají, jako kdyby někdo rozsypal písmenka — s velmi škodolibým záměrem.	complang-czcomplang
I have never quite got my head round Perl - I can see the power but it just offends my senses somehow.	Jazyku Perl jsem nikdy nepřišel tak úplně na chuť. Vidím sice jeho sílu, ale nějakým způsobem prostě uráží mé smysly.	complang-czcomplang
Everything just looks a bit too much like its been stuck together with sticky tape and glue rather than coherently designed.	Všechno v něm tak trochu (nebo i trochu víc), jako kdyby to drželo pohromadě spíše díky lepicí pásce a lepidlu, než díky srozumitelnému, logickému návrhu.	complang-czcomplang
(Its OO mechanism in particular!)	(Jeho mechanismu pro objektové programování se to týká především.)	complang-czcomplang
What cannot be denied is that the WWW is driven by Perl to a very large extent and if you are curious then don't let me stop you!	Nelze popřít, že svět WWW je řízen Perlem do značné míry. Pokud vás přitahuje, nenechte se mnou zastavit!	complang-czcomplang
Instead visit: http://www.perl.org Hello World $msg = "Hello World"; print $msg;	Místo toho navštivte stránky http://www.perl.org/ . Hello World $msg = "Hello World"; print $msg;	complang-czcomplang
Python	Python	complang-czcomplang
Perl for purists, especially OO purists. I love it to bits!	Je to Perl pro puristy — zejména pro objektově orientované puristy. Miluji jej do posledního bitu!	complang-czcomplang
Python is object oriented throughout, it has an extensive module system and is designed to allow scripting on a large scale.	Python je objektově orientovaný skrz naskrz. Jeho součástí je rozsáhlý systém modulů. Python je navržen tak, aby dovoloval skriptování ve velkém [1] .	complang-czcomplang
Although much less well known than Perl you can achieve pretty much the same results for the same effort in Python as you can with Perl - and you might even understand the resultant code 6 months later.	Ačkoliv je mnohem méně známý, než Perl, můžete v jazyce Python dosáhnout stejných výsledků při srovnatelném úsilí — a výslednému kódu budete pravděpodobně rozumět dokonce i po šesti měsících.	complang-czcomplang
Hello World #!/local/bin/python class Message: def __init__(self, str="No message provided"): self.text = str def print(self): print self.text if __name__ == "__main__": m = Message("Hello World") m.print()	Hello World #!/local/bin/python class Message: def __init__(self, str="No message provided"): self.text = str def printIt(self): print self.text if __name__ = "__main__": m = Message("Hello World") m.printIt()	complang-czcomplang
	Poznámka překladatele: Uvedený příklad v jazyce Python odpovídá variantám, kdy tvoříme samostatnou třídu pro zprávu (message).	complang-czcomplang
	V Pythonu můžeme samozřejmě napsat i jednodušší ekvivalent perlovského programu, který vznikne pouhým odmazáním dvou znaků $ a dvou středníků:	complang-czcomplang
	msg = "Hello World" print msg	complang-czcomplang
	Pokud ale trochu znáte Perl, musíte uznat, že vytvoření verze programu, která by definovala třídu Message, je přinejmenším krkolomné.	complang-czcomplang
	V Perlu potřebujete k vytvoření třídy doslova požehnání (klíčové slovo bless ).	complang-czcomplang
	O přehlednosti mechanismu práce s objekty nemůže být při srovnání s jazykem Python ani řeč.	complang-czcomplang
Unix Shells	Unixový shell	complang-czcomplang
sh,csh,tcsh,ksh,bash.	sh, csh, tcsh, ksh, bash.	complang-czcomplang
Pick your favourite.	Vyberte si váš oblíbený.	complang-czcomplang
A command prompt with real power.	Jde o příkazový procesor s opravdovou silou.	complang-czcomplang
You can do if, case, while and for loops.	Můžete v něm realizovat větvení if , case , i cykly while a for .	complang-czcomplang
You can test for file type(directory, system file, access etc) There's command history access, filename and command completion, executing jobs in foreground or background etc etc.	Můžete v něm testovat typ souboru (zda se jedná o adresář, systémový soubor, přístupová práva, atd.) Udržuje historii použitých příkazů, podporuje automatické doplňování jména souboru nebo příkazu, umožňuje provádění úloh v popředí nebo v pozadí, a tak dále, a tak dále.	complang-czcomplang
Hello World #! /bin/sh message="Hello World" echo $message	Hello World #! /bin/sh message="Hello World" echo $message	complang-czcomplang
DOS Batch/NT Command	Dávkový jazyk pro DOS a Window	complang-czcomplang
What can I say? A command prompt with no power?	Co bych k němu mohl říci? Příkazový procesor s mizernou silou?	complang-czcomplang
Amazingly some people have twisted it to achieve amazing things.	Některým lidem se podařilo vymáčnout z něj maximum a dosáhnout neuvěřitlené věci.	complang-czcomplang
I still hate it though and wish Microsoft would provide a really useful batch language for Windows/NT (and shipping Perl in the Resource Kit doesn't count guys!).	Přesto jej nemám rád a přál bych si, aby Microsoft poskytnul opravdu užitečný dávkový jazyk pro Windows NT. (Ale pánové, dodávání instalace jazyka Perl jako součást Resource Kit, se nepočítá!)	complang-czcomplang
Hello World SET MSG="Hello World" ECHO %MSG% Experimental Languages	Hello World SET MSG="Hello World" ECHO %MSG% Experimentální jazyky	complang-czcomplang
Experimental here means that I have experimented with these languages.	Označení experimentální se zde vztahuje k mé osobě — experimetnoval jsem s nimi.	complang-czcomplang
It does not mean that they are some kind of computer science experiment.	To ovšem neznamená, že tyto jazyky představují nějaký experiment z pohledu počítačové vědy.	complang-czcomplang
Rather I have used these languages to write some kind of minimalist application, but only for the purpose of educating myself about the language.	Spíše by se dalo říct, že jsem v těchto jazycích napsal svým způsobem minimalistické aplikace jen proto, abych se o těchto jazycích něco dozvěděl.	complang-czcomplang
The dividing line between some of these and the little languages above is fine, but ultimately the little languages have produced tools which I use in earnest, the experimental ones produced tools which I do not use on a regular basis.	Dělící čára mezi těmito jazyky a jazyky, které jsem označil jako malé, je velmi tenká. V malých jazycích jsem ovšem vytvořil nástroje, které skutečně používám. V experimentálních jazycích jsem vytvořil nástroje, které běžně nepoužívám.	complang-czcomplang
This is not to denigrate these languages in any way - they are all production languages to someone else and I have learned valuable lessons about programming from all of them.	Tím ovšem nechci tvrdit, že jde o nějaké podřadné jazyky. Každý z nich je jinými programátory používán pro tvorbu aplikací. A každý z nich mi dal cenné lekce, týkající se programování.	complang-czcomplang
I heartily recommend to any wannabe programmer that he/she experience as many different styles of programming as possible - and these languages all offer something different from the more mainstream languages above.	Každému, kdo chce být programátorem, srdečně doporučuji, aby si vyzkoušel co nejvíce různých stylů programování. Všechny tyto jazyky v sobě mají něco, čím se liší od jazyků hlavního proudu, o kterých jsme se zmínili výše.	complang-czcomplang
BASIC	BASIC	complang-czcomplang
BASIC was technically my first programming language.	BASIC byl v podstatě mým prvním programovacím jazykem.	complang-czcomplang
But what I did with it was so trivial that I don't really consider it programming.	Ale věci, které jsem v něm dělal, byly tak jednoduché, že je ani nepovažuji za programování.	complang-czcomplang
I really started using BASIC on my CP/M Microcomputer and it introduced me to Random Access files.	BASIC jsem začal používat na svém mikropočítači s operačním systémem CP/M. Seznámil jsem se přes něj se soubory s náhodným přístupem.	complang-czcomplang
I still occasionally play with BASIC - especially if I'm working on a PC and its the only programming tool around!	Občas si ještě s jazykem BASIC hraji — zejména, když pracuji na nějakém počítači, kde je to jediný programátorský nástroj, který je tam nainstalovaný.	complang-czcomplang
Visual Basic aficionados keep trying to persuade me that the modern dialects of the language are of good quality, but despite downloading the free CCE edition and creating a few simple apps, I just cannot work up any real enthusiasm.	Nadšenci spojení pupeční šňůrou s jazykem Visual Basic mne neustále přesvědčují o tom, že kvalita moderního dialektu tohoto jazyka je dobrá. Ale přesto, že jsem si stáhl jeho zdarma dostupné vydání zvané CCE a vytvořil jsem pár jednoduchých aplikací, nevyvolal ve mně žádné opravdové nadšení.	complang-czcomplang
Sorry BASIC.	Bejziku, je mi líto.	complang-czcomplang
Hello World LET MSG$ = "Hello World" PRINT MSG$; Lisp	Hello World LET MSG$ = "Hello World" PRINT MSG$; Lisp	complang-czcomplang
Lisp is described by its fans as 'the only beautiful programming language'.	Fanoušci jazyka Lisp jej popisují jako jediný krásný programovací jazyk .	complang-czcomplang
Its detractors say Lisp stands for 'Lots of Irrelevant Silly Parentheses'.	Jeho zavilí kritici říkají, že Lisp znamená Lots of Irrelevant Silly Parentheses .	complang-czcomplang
	(Tj. mnoho zbytečných pitomých závorek .	complang-czcomplang
	Setkal jsem se také s vysvětlením Lost In Stupid Parentheses , neboli ztracen v hloupých závorkách .)	complang-czcomplang
I sympathize with both views.	Sympatizuji s oběma názory.	complang-czcomplang
Lisp really stands for List Processing and is very descriptive of how the language both looks and works.	Slovo Lisp ve skutečnosti znamená List Processing (čili zpracování seznamů). Tento jazyk je velmi názorný v tom smyslu jak vypadá a jak funguje.	complang-czcomplang
Everything in Lisp is either a list or an atom - an atom is an element of a list which is not itself a list.	V jazyce Lisp je vše buď seznam nebo atom. Atomem se rozumí prvek seznamu, který sám o sobě není seznamem.	complang-czcomplang
It is this fundamental cleanness of form and its simple syntax which provokes the 'beautiful language' reaction above.	Právě zmíněná zásadní čistota formy a jednoduchá syntaxe představují vlastnosti, které provokují k výše zmíněnému postoji o kráse jazyka .	complang-czcomplang
What I learned from Lisp is a different way to structure problems, use of recursion (something I had previously avoided as too complicated) and an appreciation of the notion that data can be a program and vice versa.	U Lispu jsem se naučil jiné způsoby strukturování problému, používat rekurzi (tedy něco, čemu jsem se dříve vyhýbal jako příliš komplikovanému) a oceňovat nápad, že data mohou být použita jako program a naopak.	complang-czcomplang
The other notable thing about Lisp is that it is one of the very earliest Computer Languages along with COBOL and Fortran.	Další věc, která u jazyka Lisp stojí za zmínku, je skutečnost, že jde o jeden z prvních počítačových jazyků, spolu s jazyky COBOL a Fortran.	complang-czcomplang
I find it interesting that these earliest languages are still each going strong in their respective fields while more modern languages (Algol, PL/1, CORAL, even ADA) have bloomed then faded from sight.	Považuji za zajímavé, že všechny tyto nejrannější jazyky jsou ve svých oblastech nasazení stále vnímány jako mocné, zatímco některé modernější jazyky (Algol, PL/1, CORAL a dokonce ADA) prošly obdobím rozmachu a pak zmizely z očí.	complang-czcomplang
Maybe the designers of those early languages knew some things that have been lost to later designers?	Mohli tvůrci oněch prvních jazyků vědět něco, co tvůrcům pozdějších jazyků uniklo?	complang-czcomplang
Finally Lisp has a number of variants.	Na závěr uveďme, že jazyk Lisp má spoustu variant.	complang-czcomplang
The versions I have used most are Elisp: the macro language of the Emacs editor, XLISP an experimental OO version and Flavors, a very early experimental OO dialect.	Osobně jsem nejvíce pracoval s verzí Elisp, což je makrojazyk editoru Emacs, XLISP, což je experimentální objektově orientovaná verze a Flavors, což je velmi ranný experimentální objektově orientovaný dialekt.	complang-czcomplang
Mainstream Lisp has acquired a standard: Common Lisp and an OO system: CLOS.	Hlavní proud jazyka Lisp se dočkal standardu jménem Common Lisp a objektově orientovaného systému, zvaného CLOS.	complang-czcomplang
CLOS is perhaps the most complete OO environment available today, albeit a fairly verbose and extremely complex one.	CLOS patří snad k nejúplnějším objektově orientovaným prostředím, která jsou dnes k dispozici, i když je to prostředí docela ukecané a velmi složité.	complang-czcomplang
For that reason I won't even attempt to do an OO Hello world.	Z tohoto důvodu jsem se ani nepokusil o objektově orienovanou verzi programu Hello world.	complang-czcomplang
Hello World Note: A Lisp program is itself a list.	Hello World Poznámka: Lispovský program je sám o sobě seznamem.	complang-czcomplang
Each element of the list is a list of instructions.	Každý prvek seznamu je seznam insrukcí.	complang-czcomplang
The instruction lists can be nested to implement conditionals, loops etc. ( (setq msg "Hello World") (print 'msg))	Seznamy s instrukcemi mohou být zanořené. Tímto způsobem se implementují podmíněné části, cykly atd. ( (setq msg "Hello World") (print 'msg))	complang-czcomplang
Logo	Logo	complang-czcomplang
I first came across Logo on my CP/M micro.	S jazykem Logo jsem se poprvé setkal na svém mikropočítači s CP/M.	complang-czcomplang
It was a strange inclusion in the software bundle: a simple programming language designed to teach children about computing using a set of commands for guiding a robot 'turtle' about the floor with a pen tracing the shapes.	Byl to trochu podivný přídavek v rámci dodávaného softwarového balíku. Jde o jednoduchý programovací jazyk, který byl navržen pro výuku programování pro děti. Používá sadu příkazů, kterými se po podlaze vodí robot zvaný želva . Želva má k dispozici tužku, kterou může kreslit různé tvary.	complang-czcomplang
	(Poznámka překladatele: Želva může na základě příkazů tužku spustit nebo zvednout a tak za sebou může zanechávat stopu svého pohybu, nebo ne.)	complang-czcomplang
This became known as turtle graphics and has been ported to many other languages, including Pascal and Smalltalk.	Tento způsob kreslení vešel ve známost jako želví grafika a byl přenesen do mnoha jiných jazyků, včetně jazyků Pascal a Smalltalk.	complang-czcomplang
Logo also had a serious side however and incorporated full List Processing capability and possesses many of the features of Lisp, including the concept of programs being lists in and of themselves.	Logo ale má i svou vážnou tvář. Zahrnuje v sobě plné schopnosti zpracování seznamů a vlastní mnoho rysů jazyka Lisp, včetně konceptu, kdy se program skládá ze seznamů a sám o sobě je seznamem.	complang-czcomplang
This makes Logo suitable for teaching (and implementing) Artificial Intelligence techniques but without the mass of parentheses and unusual syntax (from a procedural programmers viewpoint) inherent in Lisp.	Tím se Logo stává vhodným nástrojem pro výuku (a implementování) technik umělé inteligence, osvobozující studenty od hromady závorek a neobvyklé syntaxe (z pohledu procedurálních programátorů), tedy rysů, které jsou vlastní jazyku Lisp.	complang-czcomplang
More modern Logo's have OO capability and there are even versions for programming windows - complete with GUI class libraries.	Modernější verze jazyka Logo si přinášejí objektově orientované vlastnosti. Existují dokonce i verze pro programování aplikací s okny (dodávají se s objektovými knihovnami pro tvorbu grafického uživatelského rozhraní).	complang-czcomplang
Hello World To Hello MAKE "Message [Hello World] PRINT :Message End Hello Prolog	Hello World To Hello MAKE "Message [Hello World] PRINT :Message End Hello Prolog	complang-czcomplang
Prolog is different.	Prolog je jiný.	complang-czcomplang
Very different!	Velmi jiný!	complang-czcomplang
In Prolog you define rules of what you want to happen and leave the system to figure out how the system should do it.	V Prologu definujete pravidla, kterými popisujete, co se má stát , a necháte systém aby si sám našel způsob jak se toho má dosáhnout .	complang-czcomplang
This is very intuitive to beginners, and very strange to programmers trained in just about any other language.	Začátečníkům se to jeví jako velmi intuitivní a programátorům, kteří prošli výukou libovolného jiného jazyka, se to zdá velmi podivné.	complang-czcomplang
It is a mainstay of artificial intelligence research, especially in Europe and Japan.	Prolog je hlavním pilířem výzkumu umělé inteligence, zejména v Evropě a v Japonsku.	complang-czcomplang
Indeed the Japanese, in an attempt to compete with the USA in computing announced in the mid '80s that they would produce a "Fifth Generation" computer based on Prolog by 1990.	Japonci, v rámci pokusu o soupeření s USA na poli počítačů, v osmdesátých letech oznámili, že do roku 1990 vyrobí počítač páté generace , který bude založen na jazyku Prolog.	complang-czcomplang
Such a machine never appeared but the Japanese did succeed in dominating computing by the much simpler strategy of building more and better memory chips than anyone else!	Nikdy sice nespatřil světlo světa, ale Japonci uspěli v ovládnutí výpočetní oblasti díky mnohem jednodušší strategii — vyrábějí více a lepších paměťových čipů, než kdokoliv jiný.	complang-czcomplang
I played with Prolog because it was available on the VAX computer I used in my first job - I often wondered why?	S jazykem Prolog jsem si mohl pohrát, protože byl k dispozici na počítači VAX, který jsem používal ve svém prvním zaměstnání. Vždycky jsem se divil, proč tam ten Prolog je.	complang-czcomplang
We certainly never used it in any kind of production capacity.	Zcela určitě jsme jej nikdy nepoužili při řešení úkolů, kterými jsme se živili.	complang-czcomplang
I've never really written any serious code in Prolog but the whole concept fascinates me.	V Prologu jsem vlastně nikdy nenapsal nějaký důležitý program, ale jeho celková koncepce mne fascinuje.	complang-czcomplang
Maybe someday I'll find a real use for it, until then I'll keep playing when the mood takes me.	Jednoho dne pro něj možná najdu nějaké opravdové použití. Do té doby si s ním budu zatím jen hrát — když mě přepadne špatná nálada.	complang-czcomplang
Hello World Message is "Hello World" Message?	Hello World Message is "Hello World" Message?	complang-czcomplang
Smalltalk	Smalltalk	complang-czcomplang
Smalltalk is Objects.	Smalltalk, to jsou objekty.	complang-czcomplang
Everywhere.	Všude.	complang-czcomplang
Always.	Vždycky.	complang-czcomplang
Although Simula 67 is generally held to be the first OO language, Smalltalk was the one that really got the ball going in the wider world.	Ačkoliv se uznává, že prvním objektově orientovaným jazykem byla Simula 67, prvním opravdu rozšířeným se stal Smalltalk.	complang-czcomplang
During the 1970's Smalltalk evolved into what was to be the definitive OO environment: Smalltalk 80.	Během 70. let se Smalltalk vyvinul v něco, co se mělo stát úplným objektově orientovaným prostředím: Smalltalk 80.	complang-czcomplang
If you want to sample Smalltalk 80 download a copy of Squeak from Disney.com.	Pokud si chcete vyzkoušet Smalltalk 80, stáhněte si kopii Squeak z disney.com.	complang-czcomplang
The environment is a faithful copy of the Smalltalk 80 programming environment, including the GUI which is distinctly eccentric by modern standards but was the catalyst for the Mac and windows etc.	Jeho prostředí je věrnou kopií programového prostředí Smalltalk 80, včetně GUI. Jeho grafické uživatelské rozhraní je sice z dnešního pohledu zjevně excentrické, ale stalo se katalyzátorem pro vznik prostředí počítačů Macintosh, pro vznik Windows...	complang-czcomplang
My preferred Smalltalk implementation is Dolphin Smalltalk for Win95.	Mou preferovanou implementací jazyka Smalltalk je Dolphin Smalltalk pro Windows 95.	complang-czcomplang
This is unusual in that the development environment is free but if you want to distribute programs as EXEs then you need to buy a deployment kit.	Neobvyklé na něm je to, že vývojové prostředí je k dispozici zdarma. Pokud ale chcete výsledný program dodávat v podobě EXE, musíte si koupit nástroj pro jeho vytvoření.	complang-czcomplang
This seems to be a reasonable alternative to shareware as a try-before-you-buy scheme.	Zdá se, že je to rozumná alternativa k shareware v rámci přístupu vyzkoušej si, než si koupíš .	complang-czcomplang
The environment is good and the HTML format documentation and tutorial is very readable.	Vývojové prostředí je dobré a dokumentace i učebnice ve formátu HTML jsou velmi čtivě napsané.	complang-czcomplang
There is a support forum too.	Existuje i skupina, která se zabývá podporou.	complang-czcomplang
Smalltalk fans love the consistency of the language (as I said, everything is an object) and its small set of syntactic constructs - making it easy to learn.	Fanoušci jazyka Smalltalk si libují v konzistentnosti jazyka (jak jsem řekl, vše je objekt) a v tom, že existuje jen malá množina syntaktických konstrukcí — odtud vyplývá snadné naučení se jazyku.	complang-czcomplang
At least thats the idea - it took me 3 attempts with 2 different environments to get my head around it.	To má tedy být základní myšlenka. Osobně jsem musel absolvovat tři pokusy ve dvou různých prostředích, než mi to vlezlo do hlavy.	complang-czcomplang
At times Smalltalk rivals C and Perl in the use of obscure and overloaded symbols (@,#,[,], etc).	Občas je Smalltalk zdatným soupeřem jazyků C a Perl — při používání záhadných a přetížených symbolů ( @, # , [ , ] , atd.).	complang-czcomplang
Hello World message := string new: "Hello World". message print.	Hello World message := string new: "Hello World". message display.	complang-czcomplang
If you want to comment on these views please mail me.	Pokud k uvedeným pohledům chcete doplnit nějaké připomínky, napište mi , prosím.	complang-czcomplang
Back to the top	(..., ale anglicky.) [ zpět ]	complang-czcomplang
	Pokud vás napadne, co by se dalo na překladu této kapitoly vylepšit, zašlete e-mail odklepnutím	complang-czcomplang
		complang-czcomplang
		complang-czcomplang
		complang-czcomplang
		complang-czcomplang
		complang-czcomplang
		complang-czcomplang
		complang-czcomplang
		complang-czcomplang